###################
#                 #
#              x  #
#                 #
#                 #
#         x       #
#                 #
#                 #
###################
